. . . @ @ . @ @ @ @ @ . . . .
. . @ @ @ @ @ @ . @ @ . . . .
. @ @ @ @ @ @ @ . @ . . . . .
. @ @ @ @ @ @ @ @ . . @ . . .
@ @ @ @ @ @ @ @ @ @ @ @ . . .
@ @ @ @ @ @ @ @ @ @ @ @ @ . .
@ @ @ @ @ @ @ @ @ @ . @ . . .
@ @ @ @ @ @ @ @ @ @ @ @ @ . .
@ @ @ @ @ . . @ @ @ @ @ @ @ .
. @ @ @ @ . . . @ @ @ @ @ @ @
. . . . . . . . . @ @ @ @ @ @
. . . . . . . . . . . @ @ @ @