. @ @ @ @ . . . . . . . . . .
. . . @ @ @ . . . . . . . . .
@ . @ @ @ @ @ @ . . . . . . .
@ @ @ @ @ @ @ . . . . . . . .
@ @ @ @ @ . . . . . . . . . .
@ @ @ @ @ . . . . . . . . . .
@ @ @ @ @ @ . . . . . . . . .
@ . . @ @ @ . @ . . @ @ . . .
. . . @ @ @ @ @ . @ @ @ . . .
. . . . . . . . @ @ @ @ @ . .
. . . . . . . . . @ @ @ @ . .
. . . . . . . . . . . . @ @ @