@ @ @ . . . . @ @ . . . @ @ .
@ @ @ @ . . @ @ @ @ . . @ @ @
@ @ @ @ @ . @ @ @ . . @ @ @ @
@ @ @ . . @ @ @ @ @ @ . @ @ @
. @ . . . . @ @ @ . @ @ . . @
. . @ . . . . . @ . . . . . @
. @ . . . . . @ . . . . . . @
. @ @ @ . . . @ . . . . . @ @
@ @ @ @ . . @ @ @ @ . . @ @ @
@ @ @ @ @ @ @ @ @ @ @ @ . @ @
@ @ @ . . . @ @ @ @ . @ @ @ @
. @ @ . . . . . @ . . . . . .