. . . . . . . . . . . . . . .
. . . . @ @ . . . @ . @ . . .
. . . @ @ @ @ @ @ @ @ @ . . .
. . . . @ @ @ @ @ @ @ @ . @ .
. @ @ . @ @ @ @ @ @ @ @ . @ .
@ @ @ @ @ @ @ @ @ @ @ @ @ @ .
. . @ @ @ @ @ @ @ @ @ . @ . .
. . @ @ @ @ @ @ @ @ @ @ . . .
. @ @ @ . . @ @ @ @ . @ . . .
. . @ @ @ @ . @ @ . . @ @ . .
. . . @ @ . . @ @ . . @ . . .
. . . . . . . . @ . . . . . .