. . . . . . . @ @ . . @ @ @ .
. . . . . . @ @ @ . . @ @ @ @
. @ . . . @ @ . @ @ @ . @ @ @
. @ @ . . . @ . @ @ @ @ @ @ @
@ @ . . @ . . . @ @ @ @ @ @ @
. . @ @ @ @ . @ @ @ @ @ @ @ @
. . @ @ @ @ @ @ @ @ @ @ . @ @
@ @ . @ @ @ @ @ @ @ @ . . . .
@ @ @ @ @ @ @ @ @ @ . . @ @ .
@ @ @ . . @ . @ @ @ @ @ @ @ @
@ @ . . . @ . @ . @ @ @ @ @ .
. . . . . @ . . . . . . . . .