@ @ . @ @ @ @ . @ @ @ . @ @ @
@ @ @ @ @ . @ @ @ @ @ @ @ . @
@ @ @ . . @ @ @ . @ . @ @ . @
@ . @ @ . . @ @ @ @ . . . @ @
@ . . @ @ @ @ @ @ @ . @ @ @ @
. @ @ @ @ @ @ . . @ @ @ @ @ .
@ @ @ @ @ @ @ . . @ @ @ @ @ @
@ . @ @ . . @ @ @ @ @ @ @ . @
@ @ @ . . @ @ @ . @ @ . @ @ .
@ . @ @ . @ @ @ . @ @ @ . @ @
@ . @ @ @ @ @ @ @ @ @ @ @ . @
. @ @ @ @ . . @ @ @ . . @ @ @