. . . . . . . . . . . . . . .
. . . @ @ . . . . . . . . . .
. . @ @ . . . . . . . . . . .
. . . @ @ . . . . . . . . . .
. @ @ @ @ @ . . . @ . . . . .
. @ @ @ @ @ @ . . @ @ @ @ . .
. @ @ @ . . . @ @ @ @ @ @ @ .
@ @ @ @ . . . @ @ @ . @ @ @ @
@ @ @ . . . @ @ . . . @ @ @ @
. @ @ @ @ @ @ @ . . . . . @ @
@ @ @ @ . @ @ @ . . . . . @ @
@ @ @ @ @ @ @ @ . . . . @ @ @