. . @ . . @ @ @ @ @ @ @ @ @ @
. @ @ . @ @ @ @ @ @ @ @ @ @ @
@ @ . . @ @ @ @ @ @ @ @ @ @ @
@ . @ @ @ @ @ @ @ @ @ @ @ @ @
. @ @ @ @ @ @ @ @ @ @ @ . . @
. @ @ . @ @ @ @ @ @ @ @ . . @
. . . @ @ @ @ @ @ @ @ @ @ @ @
. . . . @ @ @ @ @ @ @ @ @ @ @
. . . @ @ @ @ @ @ @ . . @ @ @
. . . @ @ . . @ @ @ @ @ @ @ .
. . . . . . @ @ @ @ @ @ @ @ @
. . . . . . @ @ @ @ @ @ @ @ @