. . . . . @ @ @ @ @ @ . . . .
. . . . @ @ @ @ @ @ @ @ . . .
. . . @ @ @ @ @ @ @ @ @ @ . .
. . @ @ @ @ . . . . . @ @ @ .
. . @ @ @ . . . . . @ @ @ @ .
. . @ @ @ . . . . . . @ @ @ .
. . @ @ @ . . . . . @ @ @ @ .
. . @ @ @ @ . . . . @ @ @ @ .
. . . @ @ @ @ @ @ @ @ @ @ . .
. . . . @ @ @ @ @ @ @ @ . . .
. . . . . @ @ @ @ @ @ . . . .
. . . . . . . . . . . . . . .