. . . . . @ @ @ @ @ @ . . . .
. . . . @ @ @ @ @ @ @ @ . . .
. . . @ @ @ @ @ @ @ @ @ @ . .
. . @ @ @ @ @ @ @ @ @ @ @ @ .
. @ @ @ @ @ @ @ @ @ @ @ @ @ .
. . @ @ @ @ @ @ @ @ @ @ @ @ .
. @ @ @ @ @ @ @ @ @ @ @ @ @ .
. . @ @ @ @ @ @ @ @ @ @ @ @ .
. . . @ @ @ @ @ @ @ @ @ @ . .
. . . . @ @ @ @ @ @ @ @ . . .
. . . . . @ @ @ @ @ @ . . . .
. . . . . . . . . . . . . . .