. . . . @ @ . . . . @ . . . .
. . . . @ @ @ @ . @ @ @ @ . .
@ @ @ @ @ @ . @ @ @ @ @ @ @ @
@ @ @ @ . . . . @ @ @ @ @ @ .
@ @ @ @ @ . . @ @ @ @ @ @ @ .
. @ @ @ @ . . @ @ @ @ @ @ @ @
. @ . . @ . . @ @ @ @ @ @ . @
. @ @ @ . . . @ @ @ . @ @ . @
. @ @ @ . . . @ @ @ . @ . . .
. . @ @ . . . . @ @ . . @ . @
. . @ . . . . @ @ . . . @ @ @
. . @ . . . . . . . . . . @ @